...
.......####
.#######..#
##........#
#...@..#..#
###..###..#
..#..#....#
.#####.#.##
.#......##
.#.....##
.#######